111111111111
100C00000001
10000000C001
100000101001
1P00001C10E1
111111111111