1111111111111111111111111
1000000000000000000000011
10000C0000000000000000001
1100000000000C00000000001
1100P0000000000000C000001
1000000000000000000000011
1100000000000000000000001
1000000C00000000000000001
1000000000000000000000011
10000000000000C0000000E00
1100000000000000000000001
1100000000000000000000001
1111111111111111111111111